00000000000000000000000000000000000000000000000000000000000000000
00 ------------------- 000000000000000000000000000000000000000000
00|   [o.o]           |00000000000000000 ------------------------
00 -----------        |00000000000000000|    Z              (*o*)
00000000000000|       |00000000000000000|        ----------------
00000000000000|       |00000000000000000|       |0000000000000000
00000000000000|       |00000000000000000|       |0000000000000000
00000000000000|        -----------------        |0000000000000000
00000000000000|        C                        |0000000000000000
00000000000000|        ------------------------- 0000000000000000
00000000000000|       |000000000000000000000000000000000000000000
00000000000000|       |000000000000000000000000000000000000000000
00000000000000|       |000000000000000000000000000000000000000000
00000000000000|       |000000000000000000000000000000000000000000
00000000000000|        -------------------------------------- 000
00000000000000|                                            B |000
00000000000000|   X    -------------     V   ---------------- 000
00000000000000|       |0000000000000|       |00000000000000000000
00000000000000|       |0000000000000|       |00000000000000000000
00000000000000|       |0000000000000 ------- 00000000000000000000
00000000000000|       |000000000000000000000000000000000000000000
00000000000000|       |000000000000000000000000000000000000000000
00000000000000 ------- 000000000000000000000000000000000000000000
00000000000000000000000000000000000000000000000000000000000000000
00000000000000000000000000000000000000000000000000000000000000000