00000000000000000000000000000000000000000000000000000000000000000
00000000000000000000000000000000000000000000000000000000000000000
----------------------------------------------------------- 00000
        Z                                             X    |00000
----         -------------------------------------         |00000
0000|       |0000000000000000000000000000000000000|        |00000
0000|       |0000000000000000000000000000000000000|        |00000
0000|       |0000000000000000000000000000000000000|        |00000
0000|       |0000000000000000000000000000000000000|        |00000
0000|       |0000000000000000000000000000000000000|        |00000
0000|       |0000000000000000000000000000000000000|         -----
0000|       |0000000000000000000000000000000000000|              
0000|       |0000000000000000000000000000000000000 --------------
0000|       |0000000000000000000000000000000000000000000000000000
0000|        -------------------------------------000000000000000
0000|   B                                   V    |000000000000000
0000|        -------       --------------        |000000000000000
0000|       |0000000|                    |       |000000000000000
0000|       |0000000|                    |       |000000000000000
0000|       |0000000 ------------        |       |000000000000000
0000|       |00000000000000000000|       |------- 000000000000000
0000|       |00000000000000000000|  C    |00000000000000000000000
0000|       |00000000000000000000|        ----------------------|
0000|       |00000000000000000000|                              |
0000|       |00000000000000000000------------------------|      |
