0000000000000000000000000000000000000000000000000000000000000000 
000000000000000000 --------------------------------------------- 
000000000000000000|  Z                                          |
000000000000000000|        -----------------------------   B    |
000000000000000000|       |00000000000000000000000000000|       |
000000 -----------         --------------------------- 0|       |
000000|                                               |0|       |
000000|        ---------         ------------    X    |0|       |
000000|       |000000000|       |000000000000|        |0|       |
000000|       |000000000|       |000000000000|        |0|       |
------        |000000000|       |000000000000|        |0|       |
              |000000000|        ------------         |0|       |
-------------- 000000000|  V                          |0|       |
000000000000000000000000 ----------------------------- 0|       |
00000000000000000000000000000000000000000000000000000000|       |
00000000000000000000000000000000000000000000000000000000|       |
00000000000000000000000000000000000000000000000000000000|       |
0000000000000000000 ------- 0000000000000000000000000000|       |
0000000000000000000|       |0000000000000000000000000000|       |
0000000000000000000|       |0000000000000000000000000000|       |
000000 -------------       -----------------------------        |
000000|               C                                         |
000000 --------------------------------------------          --- 
000000000000000000000000000000000000000000000000000|        |0000
000000000000000000000000000000000000000000000000000|        |0000
