00000000000000000000000000000000000000000000000000000000000000000
00000000000000000000000000000000000000000000000000000000000000000
000000000000000000000000000000000000000000000000000000000 ------ 
0000 ------------------------ 000000000000000000000000000|      |
0000|                        |000000000000000000000000000|      |
0000|                        |000000000000000000000000000|      |
0000|                        |000000000000000000000000000|      |
0000|                         ---------------------------       |
0000|      FINAL BOSS              X                    V       |
0000|                         -----------------------         ---
0000|                        |00000000000000000000000|       |000
0000|                        |00000000000000000000000|        ---
0000|                        |00000000000000000000000|           
0000 ------------------------ 00000000000000000000000|        ---
00000000000000000000000000000000000000000000000000000|       |000
000000000000000 -------- 0000000000000000000000000000|       |000
000000000000000|   Z    |0000000000000000000000000000|       |000
000000000000000|        |0000000000000000000000000000|       |000
000000000000---        - 0000000000000000000000000000|        ---
00000000000|          |000000000000000000000000000000|           
00000000000|          |000000000000000000000000000000|        ---
00000000000|           -------------------------------   B   |000
00000000000|   C                                             |000
00000000000 ------------------------------------------------- 000
00000000000000000000000000000000000000000000000000000000000000000
