0000|       |00000000000000000000000000000000000000000000|      |
0000|       |00000000000000000000000000000000000000000000|      |
0000|       |00000000000000000000000000000000000000000000|      |
0000|        ---------------- 000000000000000000000000000|      |
0000|    Z                   |000000000000000000000000000|      |
0000 ---------------         |000000000000000000000000000|      |
00000000000000000000|        |000000000000000000000000000|      |
00000000000000000000|         ---------------------------       |
00000000000000000000|                                            
00000000000000000000|                                         ---
00000000000000000000|   X     -----------------------        |000
--------------------         |00000000000000000000000|  B    |000
                             |00000000000000000000000|       |000
---------------          ---- 00000000000000000000000|       |000
000000000000000|        |0000000000000000000000000000|       |000
000000000000000|        |0000000000000000000000000000|        ---
000000000000000|        |0000000000000000000000000000|           
000000000000000|        |0000000000000000000000000000|        ---
---------------         |0000000000000000000000000000|       |000
                        |0000000000000000000000000000|       |000
-----------             |0000000000000000000000000000|       |000
00000000000|             ----------------------------        |000
00000000000|    C                                        V   |000
00000000000 ------------------------------------------       |000
000000000000000000000000000000000000000000000000000000 ------ 000
