000000000000000000000000000000000000000000000000000|        |0000
000000000000000000000000000000000000000000000000000|        |0000
000000000000000000000000000000000000000000000000000|        |0000
0000 -------------------- 0000000000000000000000000|        |0000
0000|     Z              |0000000000000000000000000|        |0000
0000 -----------         |0000000000000000000000000|        |0000
0000000000000000|        |0000000000000000000000000|        |0000
------------ 000|         -------------------------         |0000
            |000 --                                         |0000
------------ 000000|                                         - 00
0000000000000000000|     B     -----------------------        |00
0000000000000000000|          |00000000000000000000000|       |00
00000000000000000|            |00000000000000000000000|       |00
00000000000000000|        ---- 00000000000000000000000|       |00
00000000000000000|       |0000000000000 --------------        |00
-----------------        |0000000000000|  V                   |00
                         |0000000000000|       -------        |00
----               ------ 0000000000000|      |0000000|       |00
0000|             |00000000000000000000|      |0000000|       |00
0000|             |00000000000000000000|      |0000000|       |00
0000 ------       |00000000000000000000|      |0000000|       |00
00000000000|       --------------------        -------        |00
00000000000|   X                                         C    |00
00000000000 -------------------------------------------------- 00
00000000000000000000000000000000000000000000000000000000000000000
